b	b	b
d	d	d
f	f	f
ɡ	g	g
ɥ	H	h
j	j	j
k	k	k
l	l	l
m	m	m
n	n	n
ɲ	J	n~
ŋ	N	ng
p	p	p
ʁ	R	r
s	s	s
ʃ	S	s^
t	t	t
v	v	v
w	w	w
z	z	z
ʒ	Z	z^
ø	2	x
œ	9	x^
œ̃	9~	x~
ə	@	q
a	a	a
ɑ̃	A~	a~
e	e	e
ɛ	E	e^
ɛ̃	E~	e~
i	i	i
o	o	o
ɔ	O	o^
ɔ̃	O~	o~
u	u	u
y	y	y